 #.#........#..#..#..##.#.
 ......#........#..#......
 ...#.#.............##....
 #.....#..##...#.#...#....
 ..#.....#.............##.
 ###.#............#..#.#..
 .###..###...###.#.#.##...
 #....##....#.....##.....#
 ....#.............#.#...#
 ##.#.#..#.##......#.#.#..
 #.##...#..##....###...##.
 #.....#.............#....
 #.##.#.#.........##..##..
 ..#####.#...#....#.#.....
 #....#....#.##.##...#.#.#
 ....###..###.#..........#
 ##.#.#..#.##.....#...#...
 ....##.#..#.#.#.........#
 ..#.#.##.#...##......#...
 #..#.#....#.#...#...##...
 #.....##.#.###.#.#..#....
 ..#.#.##.....#....#......
 ..............#..#.......
 .#..#.......#.#.....#..#.
 ....###......##....##..##
 \robot 0 0