#######
#.###.#
#.....#
#.###.#
#######
\robot 1 3
\robot 5 1